11111111111111111111
10E00010000000C00001
10P0100CCCC111000001
100C000C000000000001
11111111111111111111